Enzyme	Recognition Sequence
AscI	GGCGCGCC
AsiSI	GCGATCGC
FseI	GGCCGGCC
NotI	GCGGCCGC
PacI	TTAATTAA
PmeI	GTTTAAAC
PspXI	GCTCGAGG, CCTCGAGG, ACTCGAGC, CCTCGAGC, ACTCGAGG, CCTCGAGT, GCTCGAGT, ACTCGAGT, GCTCGAGC
SbfI	CCTGCAGG
SgrAI	CGCCGGCG, CACCGGCG, CGCCGGTG, CACCGGTG
SrfI	GCCCGGGC
SwaI	ATTTAAAT
BbvCI	CCTCAGC, GCTGAGG
BlpI	GCTAAGC, GCTCAGC, GCTTAGC, GCTGAGC
Bpu10I	GCTCAGG, CCTCAGC, GCTAAGG, GCTTAGG, CCTTAGC, GCTGAGG, CCTGAGC, CCTAAGC
BspQI	GAAGAGC, GCTCTTC
BstEII	GGTGACC, GGTCACC, GGTTACC, GGTAACC
Bsu36I	CCTCAGG, CCTTAGG, CCTAAGG, CCTGAGG
EcoO109I	AGGTCCT, AGGACCC, GGGGCCT, GGGTCCC, GGGTCCT, GGGCCCC, AGGCCCC, AGGTCCC, AGGACCT, GGGACCT, AGGGCCT, AGGGCCC, GGGCCCT, GGGGCCC, GGGACCC, AGGCCCT
Nb.BbvCI	CCTCAGC, GCTGAGG
Nt.BbvCI	CCTCAGC, GCTGAGG
Nt.BspQI	GAAGAGC, GCTCTTC
PaqCI	GCAGGTG, CACCTGC
PpuMI	AGGTCCT, AGGACCC, GGGTCCC, GGGTCCT, AGGTCCC, AGGACCT, GGGACCT, GGGACCC
RsrII	CGGACCG, CGGTCCG
SexAI	ACCTGGT, ACCAGGT
AatII	GACGTC
Acc65I	GGTACC
AccI	GTCGAC, GTCTAC, GTATAC, GTAGAC
AclI	AACGTT
AcuI	CTTCAG, CTGAAG
AfeI	AGCGCT
AflII	CTTAAG
AflIII	ACGTGT, ACATGT, ACGCGT, ACACGT
AgeI	ACCGGT
ApaI	GGGCCC
ApaLI	GTGCAC
ApoI	AAATTT, GAATTT, GAATTC, AAATTC
AseI	ATTAAT
AvaI	CCCGAG, CTCGAG, CTCGGG, CCCGGG
AvrII	CCTAGG
BaeGI	GGGCAC, GGGCCC, GTGCCC, GTGCAC
BamHI	GGATCC
BanI	GGTACC, GGCGCC, GGCACC, GGTGCC
BanII	GGGCTC, GAGCTC, GAGCCC, GGGCCC
BbsI	GAAGAC, GTCTTC
BciVI	GTATCC, GGATAC
BclI	TGATCA
BfuAI	GCAGGT, ACCTGC
BglII	AGATCT
BmgBI	GACGTG, CACGTC
BmrI	ACTGGG, CCCAGT
BmtI	GCTAGC
BpmI	CTGGAG, CTCCAG
BpuEI	CTCAAG, CTTGAG
BsaAI	TACGTG, CACGTG, TACGTA, CACGTA
BsaHI	GACGCC, GGCGCC, GACGTC, GGCGTC
BsaI	GGTCTC, GAGACC
BsaJI	CCTTGG, CCTCGG, CCTAGG, CCGCGG, CCCTGG, CCACGG, CCCCGG, CCAAGG, CCGTGG, CCAGGG, CCGAGG, CCTGGG, CCCGGG, CCGGGG, CCCAGG, CCATGG
BsaWI	ACCGGA, ACCGGT, TCCGGT, TCCGGA
BseRI	CTCCTC, GAGGAG
BseYI	GCTGGG, CCCAGC
BsgI	GTGCAG, CTGCAC
BsiEI	CGGCCG, CGACCG, CGGTCG, CGATCG
BsiHKAI	GAGCTC, GTGCTC, GAGCAC, GTGCAC
BsiWI	CGTACG
BsmBI	CGTCTC, GAGACG
BsmI	GCATTC, GAATGC
Bsp1286I	GAGCTC, GTGCTC, GGGCTC, GGGCAC, GGGCCC, GTGCAC, GTGCCC, GAGCAC, GAGCCC
BspDI	ATCGAT
BspEI	TCCGGA
BspHI	TCATGA
BsrBI	CCGCTC, GAGCGG
BsrDI	CATTGC, GCAATG
BsrFI	ACCGGT, ACCGGC, GCCGGT, GCCGGC
BsrGI	TGTACA
BssHII	GCGCGC
BssSI	CTCGTG, CACGAG
BstBI	TTCGAA
BstYI	AGATCC, GGATCC, AGATCT, GGATCT
BstZ17I	GTATAC
BtgI	CCGCGG, CCGTGG, CCATGG, CCACGG
BtgZI	GCGATG, CATCGC
BtsI	GCAGTG, CACTGC
Cac8I	GCTGGC, GCGAGC, GCAGGC, GCCGGC, GCGCGC, GCTCGC, GCCCGC, GCAAGC, GCCTGC, GCTTGC, GCGTGC, GCCAGC, GCTAGC, GCATGC, GCGGGC, GCACGC
DraI	TTTAAA
EaeI	CGGCCG, TGGCCA, TGGCCG, CGGCCA
EagI	CGGCCG
EarI	GAAGAG, CTCTTC
EciI	TCCGCC, GGCGGA
Eco53kI	GAGCTC
EcoP15I	CTGCTG, CAGCAG
EcoRI	GAATTC
EcoRV	GATATC
Esp3I	CGTCTC, GAGACG
FspI	TGCGCA
HaeII	GGCGCC, AGCGCT, GGCGCT, AGCGCC
HincII	GTCAAC, GTCGAC, GTTAAC, GTTGAC
HindIII	AAGCTT
HpaI	GTTAAC
Hpy166II	GTCAAC, GTTCAC, GTCGAC, GTCCAC, GTATAC, GTTTAC, GTGCAC, GTAGAC, GTGGAC, GTAAAC, GTGAAC, GTCTAC, GTTGAC, GTACAC, GTGTAC, GTTAAC
Hpy188III	TCGAGA, TCCTGA, TCTAGA, TCGGGA, TCCCGA, TCTTGA, TCCAGA, TCTCGA, TCACGA, TCATGA, TCAAGA, TCAGGA, TCCGGA, TCGTGA, TCTGGA, TCGCGA
KasI	GGCGCC
KpnI	GGTACC
MfeI	CAATTG
MluI	ACGCGT
MmeI	GTCGGA, TCCGAC, GTTGGA, TCCAAC
MscI	TGGCCA
MspA1I	CCGCTG, CAGCTG, CCGCGG, CAGCGG
NaeI	GCCGGC
NarI	GGCGCC
Nb.BsmI	GCATTC, GAATGC
Nb.BsrDI	CATTGC, GCAATG
Nb.BssSI	CTCGTG, CACGAG
Nb.BtsI	GCAGTG, CACTGC
NcoI	CCATGG
NdeI	CATATG
NgoMIV	GCCGGC
NheI	GCTAGC
NlaIV	GGGACC, GGGCCC, GGGTCC, GGTCCC, GGAACC, GGCGCC, GGTTCC, GGTACC, GGACCC, GGCCCC, GGGGCC, GGAGCC, GGATCC, GGCTCC, GGCACC, GGTGCC
NmeAIII	GCCGAG, CTCGGC
NruI	TCGCGA
NsiI	ATGCAT
NspI	GCATGT, ACATGT, ACATGC, GCATGC
PciI	ACATGT
PluTI	GGCGCC
PmlI	CACGTG
PsiI	TTATAA
PspOMI	GGGCCC
PstI	CTGCAG
PvuI	CGATCG
PvuII	CAGCTG
SacI	GAGCTC
SacII	CCGCGG
SalI	GTCGAC
ScaI	AGTACT
SfcI	CTACAG, CTATAG, CTGTAG, CTGCAG
SfoI	GGCGCC
SmaI	CCCGGG
SmlI	CTTAAG, CTCGAG, CTCAAG, CTTGAG
SnaBI	TACGTA
SpeI	ACTAGT
SphI	GCATGC
SspI	AATATT
StuI	AGGCCT
StyI	CCTTGG, CCAAGG, CCATGG, CCTAGG
XbaI	TCTAGA
XhoI	CTCGAG
XmaI	CCCGGG
ZraI	GACGTC
AlwI	GATCC, GGATC
ApeKI	GCTGC, GCAGC
AvaII	GGTCC, GGACC
BbvI	GCTGC, GCAGC
BccI	GATGG, CCATC
BceAI	ACGGC, GCCGT
BsmAI	GTCTC, GAGAC
BsmFI	GGGAC, GTCCC
BspCNI	CTCAG, CTGAG
BsrI	ACTGG, CCAGT
BstNI	CCTGG, CCAGG
BtsCI	CATCC, GGATG
BtsIMutI	CACTG, CAGTG
DdeI	CTAAG, CTCAG, CTGAG, CTTAG
FauI	GCGGG, CCCGC
Fnu4HI	GCGGC, GCTGC, GCCGC, GCAGC
FokI	CATCC, GGATG
HgaI	GACGC, GCGTC
HinfI	GAATC, GAGTC, GACTC, GATTC
HphI	GGTGA, TCACC
Hpy188I	TCGGA, TCAGA, TCCGA, TCTGA
Hpy99I	CGACG, CGTCG
HpyAV	CCTTC, GAAGG
HpyCH4III	ACTGT, ACCGT, ACAGT, ACGGT
MboII	GAAGA, TCTTC
MlyI	GAGTC, GACTC
NciI	CCCGG, CCGGG
Nt.AlwI	GATCC, GGATC
Nt.BsmAI	GTCTC, GAGAC
Nt.BstNBI	GAGTC, GACTC
PleI	GAGTC, GACTC
PspGI	CCTGG, CCAGG
Sau96I	GGACC, GGTCC, GGGCC, GGCCC
ScrFI	CCCGG, CCGGG, CCAGG, CCTGG
SfaNI	GCATC, GATGC
StyD4I	CCCGG, CCGGG, CCAGG, CCTGG
TfiI	GAATC, GATTC
Tsp45I	GTCAC, GTGAC
AciI	GCGG, CCGC
AluI	AGCT
BfaI	CTAG
BstUI	CGCG
CviKI-1	GGCT, AGCC, AGCT, GGCC
CviQI	GTAC
DpnI	GATC
DpnII	GATC
FatI	CATG
HaeIII	GGCC
HhaI	GCGC
HinP1I	GCGC
HpyCH4IV	ACGT
HpyCH4V	TGCA
MluCI	AATT
MnlI	GAGG, CCTC
MseI	TTAA
MspI HpaII	CCGG
MspJI	CAGA, CGCA, CGTA, TTTG, CATG, TGTG, CCCA, CTCG, CGGA, CTCA, TTCG, TCGG, TATG, CAAA, CCTG, CGTG, CTGG, CTAG, CCGG, CCTA, TAGG, CTAA, CCCG, CAGG, CATA, CTTA, TCTG, TCAG, TTGG, CGCG, CAAG, TCCG, CCAG, CACG, TGCG, CGAA, TGGG, CGAG, TACG, CCAA, CTGA, TTAG, TAAG, CCGA, TGAG, CACA, CGGG, CTTG
NlaIII	CATG
RsaI	GTAC
TaqI	TCGA
Nt.CviPII	CCA, CCG, TGG, AGG, CCT, CGG
