AscI: GGCGCGCC
AsiSI: GCGATCGC
FseI: GGCCGGCC
NotI: GCGGCCGC
PacI: TTAATTAA
PmeI: GTTTAAAC
PspXI: ACTCGAGC, ACTCGAGG, ACTCGAGT, CCTCGAGC, CCTCGAGG, CCTCGAGT, GCTCGAGC, GCTCGAGG, GCTCGAGT
SbfI: CCTGCAGG
SgrAI: CACCGGCG, CACCGGTG, CGCCGGCG, CGCCGGTG
SrfI: GCCCGGGC
SwaI: ATTTAAAT
BbvCI: CCTCAGC
BlpI: GCTAAGC, GCTCAGC, GCTGAGC, GCTTAGC
Bpu10I: CCTAAGC, CCTCAGC, CCTGAGC, CCTTAGC
BspQI: GCTCTTC
BstEII: GGTAACC, GGTCACC, GGTGACC, GGTTACC
Bsu36I: CCTAAGG, CCTCAGG, CCTGAGG, CCTTAGG
EcoO109I: AGGACCC, AGGACCT, AGGCCCC, AGGCCCT, AGGGCCC, AGGGCCT, AGGTCCC, AGGTCCT, GGGACCC, GGGACCT, GGGCCCC, GGGCCCT, GGGGCCC, GGGGCCT, GGGTCCC, GGGTCCT
Nb.BbvCI: CCTCAGC
Nt.BbvCI: CCTCAGC
Nt.BspQI: GCTCTTC
PaqCI: CACCTGC
PpuMI: AGGACCC, AGGACCT, AGGTCCC, AGGTCCT, GGGACCC, GGGACCT, GGGTCCC, GGGTCCT
RsrII: CGGACCG, CGGTCCG
SexAI: ACCAGGT, ACCTGGT
AatII: GACGTC
Acc65I: GGTACC
AccI: GTAGAC, GTATAC, GTCGAC, GTCTAC
AclI: AACGTT
AcuI: CTGAAG
AfeI: AGCGCT
AflII: CTTAAG
AflIII: ACACGT, ACATGT, ACGCGT, ACGTGT
AgeI: ACCGGT
ApaI: GGGCCC
ApaLI: GTGCAC
ApoI: AAATTC, AAATTT, GAATTC, GAATTT
AseI: ATTAAT
AvaI: CCCGAG, CCCGGG, CTCGAG, CTCGGG
AvrII: CCTAGG
BaeGI: GGGCAC, GGGCCC, GTGCAC, GTGCCC
BamHI: GGATCC
BanI: GGCACC, GGCGCC, GGTACC, GGTGCC
BanII: GAGCCC, GAGCTC, GGGCCC, GGGCTC
BbsI: GAAGAC
BciVI: GTATCC
BclI: TGATCA
BfuAI: ACCTGC
BglII: AGATCT
BmgBI: CACGTC
BmrI: ACTGGG
BmtI: GCTAGC
BpmI: CTGGAG
BpuEI: CTTGAG
BsaAI: CACGTA, CACGTG, TACGTA, TACGTG
BsaHI: GACGCC, GACGTC, GGCGCC, GGCGTC
BsaI: GGTCTC
BsaJI: CCAAGG, CCACGG, CCAGGG, CCATGG, CCCAGG, CCCCGG, CCCGGG, CCCTGG, CCGAGG, CCGCGG, CCGGGG, CCGTGG, CCTAGG, CCTCGG, CCTGGG, CCTTGG
BsaWI: ACCGGA, ACCGGT, TCCGGA, TCCGGT
BseRI: GAGGAG
BseYI: CCCAGC
BsgI: GTGCAG
BsiEI: CGACCG, CGATCG, CGGCCG, CGGTCG
BsiHKAI: GAGCAC, GAGCTC, GTGCAC, GTGCTC
BsiWI: CGTACG
BsmBI: CGTCTC
BsmI: GAATGC
Bsp1286I: GAGCAC, GAGCCC, GAGCTC, GGGCAC, GGGCCC, GGGCTC, GTGCAC, GTGCCC, GTGCTC
BspDI: ATCGAT
BspEI: TCCGGA
BspHI: TCATGA
BsrBI: CCGCTC
BsrDI: GCAATG
BsrFI: ACCGGC, ACCGGT, GCCGGC, GCCGGT
BsrGI: TGTACA
BssHII: GCGCGC
BssSI: CACGAG
BstBI: TTCGAA
BstYI: AGATCC, AGATCT, GGATCC, GGATCT
BstZ17I: GTATAC
BtgI: CCACGG, CCATGG, CCGCGG, CCGTGG
BtgZI: GCGATG
BtsI: GCAGTG
Cac8I: GCAAGC, GCACGC, GCAGGC, GCATGC, GCCAGC, GCCCGC, GCCGGC, GCCTGC, GCGAGC, GCGCGC, GCGGGC, GCGTGC, GCTAGC, GCTCGC, GCTGGC, GCTTGC
DraI: TTTAAA
EaeI: CGGCCA, CGGCCG, TGGCCA, TGGCCG
EagI: CGGCCG
EarI: CTCTTC
EciI: GGCGGA
Eco53kI: GAGCTC
EcoP15I: CAGCAG
EcoRI: GAATTC
EcoRV: GATATC
Esp3I: CGTCTC
FspI: TGCGCA
HaeII: AGCGCC, AGCGCT, GGCGCC, GGCGCT
HincII: GTCAAC, GTCGAC, GTTAAC, GTTGAC
HindIII: AAGCTT
HpaI: GTTAAC
Hpy166II: GTAAAC, GTACAC, GTAGAC, GTATAC, GTCAAC, GTCCAC, GTCGAC, GTCTAC, GTGAAC, GTGCAC, GTGGAC, GTGTAC, GTTAAC, GTTCAC, GTTGAC, GTTTAC
Hpy188III: TCAAGA, TCACGA, TCAGGA, TCATGA, TCCAGA, TCCCGA, TCCGGA, TCCTGA, TCGAGA, TCGCGA, TCGGGA, TCGTGA, TCTAGA, TCTCGA, TCTGGA, TCTTGA
KasI: GGCGCC
KpnI: GGTACC
MfeI: CAATTG
MluI: ACGCGT
MmeI: TCCAAC, TCCGAC
MscI: TGGCCA
MspA1I: CAGCGG, CAGCTG, CCGCGG, CCGCTG
NaeI: GCCGGC
NarI: GGCGCC
Nb.BsmI: GAATGC
Nb.BsrDI: GCAATG
Nb.BssSI: CACGAG
Nb.BtsI: GCAGTG
NcoI: CCATGG
NdeI: CATATG
NgoMIV: GCCGGC
NheI: GCTAGC
NlaIV: GGAACC, GGACCC, GGAGCC, GGATCC, GGCACC, GGCCCC, GGCGCC, GGCTCC, GGGACC, GGGCCC, GGGGCC, GGGTCC, GGTACC, GGTCCC, GGTGCC, GGTTCC
NmeAIII: GCCGAG
NruI: TCGCGA
NsiI: ATGCAT
NspI: ACATGC, ACATGT, GCATGC, GCATGT
PciI: ACATGT
PluTI: GGCGCC
PmlI: CACGTG
PsiI: TTATAA
PspOMI: GGGCCC
PstI: CTGCAG
PvuI: CGATCG
PvuII: CAGCTG
SacI: GAGCTC
SacII: CCGCGG
SalI: GTCGAC
ScaI: AGTACT
SfcI: CTACAG, CTATAG, CTGCAG, CTGTAG
SfoI: GGCGCC
SmaI: CCCGGG
SmlI: CTCAAG, CTCGAG, CTTAAG, CTTGAG
SnaBI: TACGTA
SpeI: ACTAGT
SphI: GCATGC
SspI: AATATT
StuI: AGGCCT
StyI: CCAAGG, CCATGG, CCTAGG, CCTTGG
XbaI: TCTAGA
XhoI: CTCGAG
XmaI: CCCGGG
ZraI: GACGTC
AlwI: GGATC
ApeKI: GCAGC, GCTGC
AvaII: GGACC, GGTCC
BbvI: GCAGC
BccI: CCATC
BceAI: ACGGC
BsmAI: GTCTC
BsmFI: GGGAC
BspCNI: CTCAG
BsrI: ACTGG
BstNI: CCAGG, CCTGG
BtsCI: GGATG
BtsIMutI: CAGTG
DdeI: CTAAG, CTCAG, CTGAG, CTTAG
FauI: CCCGC
Fnu4HI: GCAGC, GCCGC, GCGGC, GCTGC
FokI: GGATG
HgaI: GACGC
HinfI: GAATC, GACTC, GAGTC, GATTC
HphI: GGTGA
Hpy188I: TCAGA, TCCGA, TCGGA, TCTGA
Hpy99I: CGACG, CGTCG
HpyAV: CCTTC
HpyCH4III: ACAGT, ACCGT, ACGGT, ACTGT
MboII: GAAGA
MlyI: GAGTC
NciI: CCGGG, CCCGG
Nt.AlwI: GGATC
Nt.BsmAI: GTCTC
Nt.BstNBI: GAGTC
PleI: GAGTC
PspGI: CCAGG, CCTGG
Sau96I: GGACC, GGCCC, GGGCC, GGTCC
ScrFI: CCAGG, CCCGG, CCGGG, CCTGG
SfaNI: GCATC
StyD4I: CCAGG, CCCGG, CCGGG, CCTGG
TfiI: GAATC, GATTC
Tsp45I: GTGAC, GTCAC
AciI: CCGC
AluI: AGCT
BfaI: CTAG
BstUI: CGCG
CviKI-1: AGCC, AGCT, GGCC, GGCT
CviQI: GTAC
DpnI: GATC
DpnII: GATC
FatI: CATG
HaeIII: GGCC
HhaI: GCGC
HinP1I: GCGC
HpyCH4IV: ACGT
HpyCH4V: TGCA
MluCI: AATT
MnlI: CCTC
MseI: TTAA
MspJI: CAAA, CAAG, CACA, CACG, CAGA, CAGG, CATA, CATG, CCAA, CCAG, CCCA, CCCG, CCGA, CCGG, CCTA, CCTG, CGAA, CGAG, CGCA, CGCG, CGGA, CGGG, CGTA, CGTG, CTAA, CTAG, CTCA, CTCG, CTGA, CTGG, CTTA, CTTG
NlaIII: CATG
RsaI: GTAC
TaqI: TCGA
Nt.CviPII: CCA, CCG, CCT
